csdm	城市代码
csmc	城市名称
nd	年度
wgc	网格长(m)
wgk	网格宽(m)
wgmc	网格名称
wgdm	网格代码
gnqdm	功能区代码
syfldm	声源分类代码
wgfgrks	网格覆盖人口数(人)
y	月
r	日
xs	小时
fz	分钟
leqa	leqa
l10a	l10a
l50a	l50a
l90a	l90a
lmax	lmax
lmin	lmin
bzc	标准差
opt_time	数据处理时间
buss_date	业务时间
agent_pk	代理主键
